|000000000000000000000000|
|000000000000000000000000|
|00000000000YYYYYYY000000|
|00000000000XXXXXXY000000|
|0000000000000000XY000000|
|00000000000XX000XY000000|
|00000000000XX00000000000|
|000000000000000000000000|
|000000000000000000000000|
|000000000000000000000000|
|000000000000000000000000|
|0XXXXXXX0000000000000000|
|YYYYYYYX0000000000000000|
|YYYYYYYX0000000000000000|
